######
##T#9#
##1#7#
##2###
#2717#
####B#