#####################
#451#873524132#24231#
###5#2#1#####4#3###2#
#186#5#279869682#5#2#
###4####2######1#6#3#
#16141779821#9529997#
###5#8#######4#####3#
#3#7#573#97839#97193#
#6#5#####9######1####
#91325#5#7#837#229#5#
#5#####9#9#5###3#6#1#
#8#31434#T#4#262#317#
#2###4#####1#8#6#6###
#77793435316#4#2#422#
###7###1#4###6#1#####
#93781#7#63833#11877#
#5#####2#3###2####4##
#19911#7#8#886#15149#
###1#####3###3#####8#
#86113626781#2278875#
#####B###############
