###########
#32343T179#
#182983495#
#349283279#
#259982548#
#126971264#
#912#######
#528253549#
#911512125#
#741273963#
####B######
