##########B##########
#2#6#4168561#9189675#
#4#9#4#1###3#7#9#9#4#
#1#8#3#2#9#8#3#9#8#1#
#9#2#9#8#8###8#######
#5#9#2#4#53439#2#3#8#
#5#8#6#2#8#9#1#3#7#9#
#2#312#4#9#4#6#1#9#6#
#6###8#6#7#1#7#7#8#4#
#5#3#6#583#2#1212364#
#5#4#7#8###9#####2#4#
#9#7#1#5#9#1#67312#5#
#7#8###6#8#5#####9###
#44621#976#28229#1#3#
#6#############3#4#4#
#22958#8976T#5#5#6#6#
###4#####1###8#7#8#2#
#8#9#454#893#143#9#1#
#6#2#6#6#2#####2#1#8#
#41698#935487857#159#
#####################
